################o###############,
################-###############,
#####----------------------#####,
#-----#####-####-####-####----##,
#-########--####-####------##--#,
#----------#####-#####-##-###--#,
#--#######-------------##-###x-#,
#-x#####---#####-##-#####-###--#,
#-######-#######-##-#####------#,
#------#----------#-------###--#,
#--###-####-###-#-##-########--#,
#----#----------#----######----#,
#-##-#-####-########-##-----#--#,
#-##-#----------#-------###-#--#,
#-##-######-~~~~~~~~~-#-###-#--#,
#--#-######-~pppdppp~-#-###-#-##,
o--#--------~p~~~~~p~-#-##--#--o,
#--###-####-~p~~~~~p~---##-##--#,
#-###--####-~ppppppp~-#-##-##--#,
#-###-#####-~~~~~~~~~-#-#--##--#,
#-###---------------------###--#,
#--######-#############-#####-x#,
#-x########-----s-----#-#####--#,
#---------#---#######----------#,
#-###########-------##########-#,
#-------------#-###--------###-#,
#-###########-#-#########-####-#,
#-###########-#-----------####-#,
#-x--------------########-----x#,
#--#############-#############-#,
#------------------------------#,
################o###############